111111111111111111111
000000000000000000000
000001100000000110111
000000000000000000000
000000000000000000000
000000000011100000000
000000000000011100000
000000000000000000000
000000000000000001110
000000000000011110000
000000000111100000000
111111111111111111111